RRRRRERRRRRR
R_______RRRR
R__RRRRRR__R
R__R____R__R
R__R____S__R
R__R____R__R
R__R____R__R
R__RRRRRR__R
R__________R
RRRRRRRRRRRR