RRRRRR__R
R____R__R
RS______R
R____R__R
R____R__R
RRRRRR__R
________R
RRRRRRRRR